1 4 0 2 1 0 3 3 
1 3 4 1 1 2 3 3 
0 4 3 3 3 4 1 2 
2 2 2 0 4 2 2 2 
3 2 2 4 4 0 2 0 
