3 4 4 4 1 2 2 1 
3 3 1 3 2 4 1 0 
2 2 0 3 2 4 0 2 
2 4 0 2 2 4 4 4 
0 3 0 2 3 0 4 2 
